    A B C D E F G H I J
   ---------------------
1 | ~ ~ ~ ~ ~ ~ ~ ~ ~ ~ |
2 | ~ ~ ~ ~ ~ ~ ~ ~ ~ ~ |
3 | ~ ~ ~ ~ ~ ~ ~ ~ ~ ~ |
4 | ~ ~ ~ ~ ~ ~ ~ ~ ~ ~ |
5 | ~ ~ ~ ~ ~ ~ ~ ~ ~ ~ |
6 | ~ ~ ~ ~ ~ ~ ~ ~ ~ ~ |
7 | ~ ~ ~ ~ ~ ~ ~ ~ ~ ~ |
8 | ~ ~ ~ ~ ~ ~ ~ ~ ~ ~ |
9 | ~ ~ ~ ~ ~ ~ ~ ~ ~ ~ |
10| ~ ~ ~ ~ ~ ~ ~ ~ ~ ~ |
   ---------------------


   print (a,b,c,d,e,f,g,h,i,j)
   maybe just have 10x10 